11111111111111111111
10010000000000000001
10C01111111111111111
1000100000000P000001
1000100000000C000001
100100000I0000000001
10010000000000000001
10000111110000000001
100011000000000E0001
11111111111111111111
