1111111111111
100100C0000C1
100C011111II1
1P0011E0000I1
1111111111111